################################################################
######                             ###                         <
#####                               ###                        <
##               ##                  ###                       #
##               ##                   ###                      #
|          ##          ##              ###                     #
|          ##     P    ##                                      #
##                           ##                                #
##               ##           ##                               #
######           ##           ##                               #
#########                    ##                                |
###################################    #    #    #    ##########
###################################    #    #    #    ##########
###################################    #    #    #    ##########
###################################    #    #    #    ##########
#                                                              #
#                                 #                            #
#          ###                                                 #
#          ###    ###                        #                 #
#                 ###                                          #
#                             ###                              #
#                             ###        #                     #
#     #              ###                                       #
#                   ###                                        #
##            #                ###                             #
###                           ###                              #
####                                          ###              #
#####               #                          ###             #
######                                                         #
################################################################
