################################################################
######                                                         <
#####                                                          <
##               ##                                            #
##               ##                                            #
|          ##          ##                                      #
|          ##     P    ##                                      #
##                           ##                                #
##               ##           ##                               #
######           ##           ##                               #
#########                    ##                                |
###################################                            #
#                                                              #
#                                                              #
#                                                              #
#                                                              #
#                                                              #
#                                                              #
#                                                              #
#                                                              #
#                                                              #
#                                                              #
#                                                              #
#                                                              #
#                                                              #
#                                                              #
#                                                              #
#                                                              #
#                                                              #
################################################################
