################################################################
##                                                             #
##                                                             #
##      ########        ########        ########               #
##      ########        ########        ########               #
##                                                             #
##                                                             #
##      ########        ########        ########               #
##      ########        ########        ########               #
##                                                             #
##                                                             #
##      ########        ########        ########               #
##      ########        ########        ########               #
##                                                             #
##                                                             #
##      ########        ########        ########               #
##      ########        ########        ########               #
##                                                      ########
##                                                      ########
##                                                      ########
##                                                      ########
##    #############            %%%%%                    ########
##    #############            %%%%%%                   ########
##               ##                 %%%%%%%%%%          ########
##               ##                  %%%%%%%%%          ########
##     #######   ##                   %%                ########
##     #######   ##                    %%               ########
##     ##        ##                     %%%%%%          ########
##  P  ##        ##                      %%%%%          ########
################################################################
                                                                